             NO ./textures/northblue.xpm
                        SO ./textures/southgreen.xpm

WE ./textures/westred.xpm

 EA ./textures/eastyellow.xpm

F 102, 204, 102
C 128, 193, 255






111111111111111111111111111
100000001110000000000000111
100000001000111111110110111
100000000011111100000100011
100000001100011100010101011
100000001000011100010101011111111111111111
111111111111110001110001000000000000000001
100000000000000001110111111111111111111101
101111111111110111000001000111111111111101
111111111111111111010100100000000000000001
100000000001   111000000100011111011111101
1000S0000001 11100000010001111111011111101
100000000001   101101010011111111011111101
100000000001111111110110111110000000000001
101101111111000000001110111000111111111111
101101111111011111101110111011111111111111
1011000000000111111011101110000000011
1011011111111100001000101111111111001
1011000000000001101010001111111000101
1011011111101111001010111110000010000 
1011011000100011011010111110111011111
10110110111010000000100000000010000001
10111110111110111111111110111011010111
100000000000001111111       1000010001   
111111111111111111111       1111111111




















